...................
...................
..S-------------7..
..|.............|..
..|.F---------7.|..
..|.|.........|.|..
..|.|.........|.|..

. | | . . . . | | .

. | L - 7 F - J | .

. | . . | | . . | .

. L - - J L - - J .

. . . . . . . . . .